#...............................................................................................###############........................
##...................................................................#####......#...............###############........................
####.......................................#########...........#########O#.#.......#..##........###############........................
####.........................###....###.......#######........#...#########....#..........#......##########.............................
####...................#####..........................|||......#....####O#.................##...###..........####||||||....||||####....
#######......................###............||........#####........#######.....|||####...............######..######################....
#########...............................######..................########O#.....########........#############.######################....
########....###............#######....########.............###############.......####...........###########............................
#################|||||..############..########............##############O###....................###############...######...............
##############################################...........#################......................########################....###.....###